43333333333333333333333333334
30000000000000000000000000003
30101010101010101010101010103
30101010101010101010101010103
30101010000000000000001010103
30101011111111011111111010103
30101000000000000000000010103
30101011111101110111111010103
30100000000000000000000000103
30101111011111111111011110103
30000000000000000000000000003
30101111010111011101011110103
30100000010000000001000000103
30111111110111011101111111103
30000000000155555100000000003
30111111110111111101111111103
30100000010000000001000000103
30101111010111111101011110103
30000000000000000000000000003
30101111011111111111011110103
30100000000000000000000000103
30101011111101110111111010103
30101000000000000000000010103
30101011111111011111111010103
30101010000000000000001010103
30101010101010101010101010103
30101010101010101010101010103
30000000000000000000000000003
43333333333333333333333333334